1111111111111111111111111
1104001111100000000000011
1100101111000000000000011
1006100110000000000000011
1000110110000000000000011
1115110011100000000000011
1000000011111100000030011
1000000000111111000000011
1000000000001111110000011
1000100000000001111100011
1000100000000000000000011
1000100000000000000000011
1000111000000000000000011
1000111100000000000000011
1000111110000000000000011
1000011111111100000000011
1000000111111110000000011
1000000000000011000000011
1000000000000011000000011
1000000000000011110000011
1000000000000011111100011
1000000000200011111110011
1000000000000011111111011
1111111111111111111111111