1111111111111111111111111
1111111111111111111111111
1100004111111110000000011
1110604411100000000000011
1110004010030000000000011
1111000001000111100000011
1111044040111100111110011
1111140444000000001110011
1111100400000000005550011
1111144400000000001110011
1110000100000000041111111
1110011110000004004000111
1110101000000004444000111
1111000000000004100000011
1110000000000001100000011
1100000000000001100000011
1100000000000001100020011
1110000000000001100000011
1110000000000000100000011
1110000000000000100000011
1111110001111000100000011
1111111111111100100000011
1111111111111111110000011
1111111111111111111111111