1111111111111111111111111
1000000000000407770000011
1000000000000447970000011
1000000000000007774000011
1000000000000000400000011
1000000000000000000000011
1000000000000000000000011
1000000000000000000000011
1000000000000000000000011
1000000000000000000000011
1111111100000000000000011
1111100000000000000000011
1111000000000000000000011
1110000000000000000000011
1000000000000000000000011
1000000000000000000000011
1000000000000000444444411
1000000000000011555550011
1000000000000011008050011
1000000000000011110050011
1000000000000011111100011
1000000000000011111110011
1000200000000011111111011
1111111111111111111111111