1111111111111111111111111
1000111100001111111111111
1020011100000000000011111
1000011000000000000000111
1000010000000000000000011
1000010000006000000000011
1000040000000000000000011
1100040000000000000000011
1110040000000000000000111
1111111100000000000000111
1111111100000000000000111
1111111000000000000000111
1111000000000000000011111
1110000000000000111111111
1100000000000001111111111
1000000000000055000111111
1000000000000055000000111
1110000000000055000000011
1111100000011055000000011
1111100000011155500000011
1111110000011115500030011
1111110001111110000000011
1111100111111110000000111
1111111111111111111111111